# station	xd	s_xd_xd	s_xd_yd	s_xd_zd	yd	s_yd_xd	s_yd_yd	s_yd_zd	zd	s_zd_xd	s_zd_yd	s_zd_zd
1	0	1000	0	0	0	0	1000	0	0	0	0	1000
2	0	1000	0	0	0	0	1000	0	0	0	0	1000
3	0	1000	0	0	0	0	1000	0	0	0	0	1000
4	0	1000	0	0	0	0	1000	0	0	0	0	1000
5	0	1000	0	0	0	0	1000	0	0	0	0	1000
6	0	1000	0	0	0	0	1000	0	0	0	0	1000
7	0	1000	0	0	0	0	1000	0	0	0	0	1000
8	0	1000	0	0	0	0	1000	0	0	0	0	1000
9	0	1000	0	0	0	0	1000	0	0	0	0	1000
10	0	1000	0	0	0	0	1000	0	0	0	0	1000
